Text	  Generated	  from	  Images	  
canada,	  nature,	  
sunrise,	  ontario,	  fog,	  
mist,	  bc,	  morning	  
insect,	  bulerﬂy,	  insects,	  
bug,	  bulerﬂies,	  
lepidoptera	  
graﬃ4,	  streetart,	  stencil,	  
s4cker,	  urbanart,	  graﬀ,	  
sanfrancisco	  
portrait,	  child,	  kid,	  
ritralo,	  kids,	  children,	  
boy,	  cute,	  boys,	  italy	  
dog,	  cat,	  pet,	  kilen,	  
puppy,	  ginger,	  tongue,	  
kily,	  dogs,	  furry	  
sea,	  france,	  boat,	  mer,	  
beach,	  river,	  bretagne,	  
plage,	  brilany	  
Given
	  
	  	  
Generated 	  
	  	  
Given
	  
	  	  
Generated 	  
	  	  
[Courtesy,	  R.	  Salakhutdinov]	  
